111111111111111111111111111111111111
100000000000000000000000000000000001
100000000000000000000000000000000001
100000000011110000000000001111000001
100000000010010000000000001001000001
100000000010010000000000001001000001
100000000011110000000000001111000001
100000000000000000000000000000000001
100000000000000000111100000000000001
100000000000000000100100000000000001
100000000000000000100100000000000001
100000000000000000111100000000000001
100000000000000000000000000000000001
100000000000000000000000000000000001
100000000000000N00000000000000000001
100000000000000000000000000000000001
100000000000000000001111100000000001
100000000000000000001000100000000001
100000000000000000001111100000000001
100000000000000000000000000000000001
111111111111111111111111111111111111