111111111111111111111111111111111111111111
100000000000000000000000000000000000000001
100000000000000000000000000000000000000001
100000000000001111111111111100000000000001
100000000000001000000000000100000000000001
100000000000001000000000000100000000000001
100000000000001000000000000100000000000001
100000000000001111111111111100000000000001
100000000000000000000000000000000000000001
100000000011111000000000001111100000000001
100000000010001000000000001000100000000001
1000000000100010000000N0001000100000000001
100000000010001000000000001000100000000001
100000000011111000000000001111100000000001
100000000000000000000000000000000000000001
100000111111000000000000000000001111100001
100000100001000000011111111100001000100001
100000100001000000010000000100001000100001
100000100001000000011111111100001000100001
100000111111000000000000000000001111100001
100000000000000000000000000000000000000001
100000000000000111111000001111110000000001
100000000000000100001000001000010000000001
100000000000000100001000001000010000000001
100000000000000111111000001111110000000001
100000000000000000000000000000000000000001
111111111111111111111111111111111111111111