NO ./textures/north.xpm
SO ./textures/south.xpm
WE ./textures/west.xpm
EA ./textures/east.xpm

F 100,100,50
C 50,50,80

111111111111111111111111
100000000000000000000001
100000000000000000000001
100000111110000000000001
100000100010000000000001
100000100010000011111001
100000100010000010001001
100000111110000010001001
100000000000000010001001
100000000000000011111001
100000000000000000000001
100000000000000000000001
10000000000N000000000001
100000000000000000000001
100000000000000000000001
100000001111100000000001
100000001000100000000001
100000001000100000000001
100000001111100000000001
100000000000000000000001
100000000000000000000001
100000000000000000000001
100000000000000000000001
111111111111111111111111