NO ./textures/north.xpm
SO ./textures/south.xpm
WE ./textures/west.xpm
EA ./textures/east.xpm

F 220,100,0
C 225,30,0

1111111111111111111111111111111111111111
1000000010000000001000000000100000000001
1011110010111111101111111010101111111101
1010000010100000100000001010101000000101
1010111110101110111111101010101011110101
1010000000101000000000101010001010000101
1011111110101111111110101011111010111101
1000000010100000000010001000001010000001
1111110010111111110011111111101011111101
1000010010000000010000000000101000000101
1011010111111110010111111110101111110101
100N010000000010010100000010100000010001
1011011111111010110101111010101111010111
1000000000001000000100001010100001010001
1111111111111111111111111111111111111111